%%%%%%%%%
%.     o%
%       %
%       %
%  %%%  %
%  %%%  %
%   %   %
%  P    %
%%%%%%%%%