%%%%%%%%
%      %
%P.   .%
%      %
%%%%%%%%