%%%%%%%%
%      %
%    P.%
%      %
%%%%%%%%